A possible greedy path:
(0,0)(1,1)(2,2)(3,3)(4,3)(5,4)(6,5)(7,6)(8,7)(9,8)(10,9)(11,10)(12,11)(12,12)(13,13)(14,14)(15,15)(16,15)(17,16)(18,16)(19,17)(20,18)(21,18)(22,19)(23,20)(24,21)(25,22)(26,23)(27,24)(28,24)(29,25)(29,26)(29,27)(29,28)(29,29)(29,30)(29,31)(29,32)(29,33)(29,34)(29,35)(29,36)(29,37)(29,38)(29,39)(29,40)(29,41)(29,42)(29,43)(29,44)(29,45)(29,46)(29,47)(29,48)(29,49)
Length= 55

Path 2D:
*1111111111111010101111011110110110101110111111111
1*111010110011111111111111111100111110110100111111
11*11111111001101111101111110110101110111111011100
011*1110111110011111011011111010111110111010110100
011*0111101111111111100011111011111111001110111100
1111*111011110100111011111111110111110010110110011
10111*11111110111100110111011011111111010111111100
011101*1111111111111111111111110001111111011101011
1110100*111111111111111000111101110111010111101111
01111111*11111111011111111000111111101110111010111
101011101*1100111101111111111111001100010100111010
1111111111*111111111010011111110011010101110111010
11110111111**1111111100111111111011101111111111011
1110111011100*111111110111111111101100101011111111
01111011110111*11111110111010111011111101001111111
010100111111111*1111111111010111011111101111110111
010101111111111*0111011110111011011011111111111111
0110100110111101*111111111101111110111101111110110
1110111000101111*011111111100111110100100111101110
11111110111101111*10100111111111111111100110110111
111101111011011110*1111100111111110111111000111101
111010011101101011*0011111111111101011111111111011
1101111110101111101*111111111110110101111001111111
11111110011111101111*11111110111011010111111111101
111111111111110100111*1111111011111011100111111111
0111111011010111110010*111011111111111011111011111
01111111111110111110111*11111111110111111111001011
111100011111011111111010*1101111111111111111010110
101101110011111111110010*0111111011111011100111111
1111110011111111111111111*************************
