20
1 1 1 1 1 1 1 1 1 1 1 1 1 1 1 1 1 1 1 1
1 0 0 0 0 0 0 0 0 0 0 0 0 0 0 0 0 0 0 1 
1 0 1 0 1 1 1 1 1 1 1 1 1 1 1 1 0 1 0 1
1 0 1 0 0 0 0 0 0 0 0 0 0 0 0 0 0 1 0 1
1 0 1 1 1 0 1 0 0 0 0 0 0 1 0 1 1 1 0 1
1 0 0 0 0 0 1 0 0 0 0 0 0 1 0 0 0 0 0 1
1 0 1 0 1 1 1 1 0 1 1 0 1 1 1 1 0 1 0 1
1 0 1 0 0 0 1 0 0 0 0 0 0 1 0 0 0 1 0 1
1 0 1 0 1 0 0 0 1 0 0 1 0 0 0 1 0 1 0 1
1 0 1 0 1 1 1 0 1 1 1 1 0 1 1 1 0 1 0 1
1 0 1 0 0 0 0 0 1 0 0 1 0 0 0 0 0 1 0 1
1 0 1 0 1 1 1 0 1 1 1 1 0 1 1 1 0 1 0 1
1 0 1 0 0 0 0 0 0 0 0 0 0 0 0 0 0 1 0 1
1 0 1 0 1 1 1 1 0 1 1 0 1 1 1 1 0 1 0 1
1 0 0 0 0 0 1 0 0 0 0 0 0 1 0 0 0 0 0 1
1 0 1 1 1 0 1 0 1 1 1 1 0 1 0 1 1 1 0 1
1 0 1 0 0 0 0 0 1 0 0 1 0 0 0 0 0 1 0 1
1 0 1 0 1 1 1 1 1 1 1 1 1 1 1 1 0 1 0 1
1 0 0 0 0 0 0 0 0 0 0 0 0 0 0 0 0 0 0 1
1 1 1 1 1 1 1 1 1 1 1 1 1 1 1 1 1 1 1 1 
9 12
1 1
18 18
18 1
1 18